1111111111111111111111111111111
1000000010000010000010000000001
1011101010111010101110111011101
1X10001010101010100000100010101
1110111010101010111111101110101
10001X1010001000100000001010001
1011101011101111101111111010111
101000101X001000001X001000001X1
1010111011111011111110101111101
1010000010000010000010101000001
1011101110111110111010101110101
1000100000100000100010000010101
1010111011101111101111111010111
1010001010001010001000001010001
1011101010111010101011101011101
1010001010100010101010101010001
1010111110101010111010101010111
1010000000101010001000101010001
1011111111101011101110101011101
1000001000001010000010101000101
1111101010111010111110101110101
1X10001010100010000000101010001
1010111110101111111111101011101
1010100010101000100000101010001
1010101010101010101110101010111
101000101010001X100010001000101
1011111010111111101011111011101
10000010001000001010100X1000101
1011111110111110111010111110101
1000000000000010000010000000001
1111111111111111111111111111111