1111111111111111111111111111111111111
1X0010000000000000000000000X100000001
1000100000000000000000000000100000001
1000100000000000000000000000100000001
1000100011111111100011111111100010001
100000001000000X100000000000000010001
1000000010000000100000000000000010001
1000000010000000100000000000000010001
1000111110001111111110001111111110001
1000000000001000000010000000100000001
1000000000001000000010000000100000001
100000000000100000001000000X100000001
1000111111111000100011111111100011111
1000100000001000100010000000100000001
1000100000001000100010000000100000001
1X00100000001000100010000000100000001
1111100010001000100010001000111110001
1000000010000000100000001000000000001
1000000010000000100000001000000000001
1000000010000000100000001000000000001
1000100011111111111111111111111111111
1000100010000000100000000000000000001
1000100010000000100000000000000000001
1000100010000000100000000000000000001
1000100010001000100011111111111110001
1000100010001000100010000000000010001
1000100010001000100010000000000010001
1000100X10001000100010000000000010001
1000111110001000100010001111111110001
1000000000001000000010001000000000001
1000000000001000000010001000000000001
1000000000001000000010001000000000001
1000111111111111111110001000111110001
1000000000000000000010000000100000001
1000000000000000000010000000100000001
1000000000000000000X100000001X0000001
1111111111111111111111111111111111111